8
######.#
#.#....#
#...#.##
#.######
#..#..G#
##...###
#.S#...#
#.######
