64
##############################..................................
..S..........................#..................................
.#...........................#..................................
.#.#######################...#..................................
.#.......................#...#..................................
.#.......................#...#..................................
.#.......................#...#..................................
.#.......................#...#..................................
.#.......................#...#..................................
.#.......................#...#..................................
.........................#...#..................................
.........................#...#..................................
..#......................#...#..................................
#.#......................#...#..................................
#.#......................#...#..................................
#.#......................#..##..................................
#.#......................#..##..................................
#.#......................#..##..................................
#.#......................#..##..................................
#.#......................#...#..................................
#.#......................#...#..................................
#.#......................#...#..................................
#.#......................#...#..................................
#.#......................#..##..................................
#.#......................#..##..................................
#.#......................#..##..................................
#.#.........................##..................................
#.#.....####....................................................
#.#######..###################..................................
##############################################################..
.............................................................#..
............................................................#...
............................................................#...
............................................................#...
............................................................#...
............................................................#...
...........................................................#....
...........................................................#....
...........................................................#....
...........................................................#....
...........................................................#....
...........................................................#....
...........................................................#....
...........................................................#....
...........................................................#....
...........................................................#....
...........................................................##...
............................................................#...
............................................................#...
............................................................##..
.............................................................#..
.............................................................#..
.............................................................#..
.............................................................#..
.............................................................#..
.............................................................#..
.............................................................#..
.............................................................#..
.............................................................#..
.............................................................#..
.............................................................#..
.............................................................##.
..............................................................#.
...............................................................G