30
##############################
..S..........................#
.#...........................#
.#.#######################...#
.#.......................#...#
.#.......................#...#
.#.......................#...#
.#.......................#...#
.#.......................#...#
.#.......................#...#
.........................#...#
.........................#...#
..#......................#...#
#.#......................#...#
#.#......................#...#
#.#......................#..##
#.#......................#..##
#.#......................#..##
#.#......................#..##
#.#......................#...#
#.#......................#...#
#.#......................#...#
#.#......................#...#
#.#......................#..##
#.#......................#..##
#.#......................#..##
#.#......................#..##
#.#.....####.............#.G##
#.#######..###################
##############################
