10
S#########
.........#
..########
......#..#
####.#####
...#.#....
####..####
#.........
#########.
G.........