10
S#########
.........#
..########
......#..#
####.#####
...#.#....
####..####
#.........
##########
G.........