10
S.........
..........
..........
..........
..........
..........
........#.
.......#..
.......#.#
.......#.G
