10
..........
........#.
........#.
........#.
........#.
........#.
........#.
........#.
........#.
........#.
S.......#G
